ContentPane18	id
ContentPane19	id
ContentPane20	id
bginput	class
button	class
clearBoth_fmt	class
clear_fmt	class
clearboth_fmt	class
composite sect1_ctr oneCol_fmt	class
composite sect1_fmt twoCol_fmt clearfix	class
composite sect2_ctr oneCol_fmt	class
composite sect3_ctr oneCol_fmt	class
composite sect5_fmt twoCol_fmt clearfix	class
composite sect6_ctr oneCol_fmt	class
contentBackground_fmt	id
contentDivider_fmt	class
content_fmt	class
date	class
footer_fmt	class
getStartedHP_rdr	class
header_fmt	class
headlineText_fmt	class
headline_links_fmt	class
home_community	id
home_community_box	class
home_community_top	class
home_conditions	class
home_conditions_box	class
home_conditions_top	class
home_featured	id
home_featured_box	id
home_features	class
home_features_bottom	class
home_features_top	class
home_treatments	class
home_treatments_box	class
home_treatments_top	class
hotTopics_content_fmt	class
hotTopics_right_bottom_fmt	class
hotTopics_right_rdr	class
hotTopics_top_fmt	class
img	class
l_all	id
l_bannerTop	id
l_bannerTop_fmt	id
l_bottomBackground	class
l_bottomCorners	class
l_contentBottom	id
l_content_area	class
l_content_bg	id
l_footer	id
l_header	class
l_main	class
l_main_content	id
l_main_content_box	id
l_main_content_section_filler_top	id
l_main_content_section_footer	class
l_main_content_third_col	id
l_middle_content	id
l_moduleSpacer	class
l_page	id
l_pageShadowLeft	class
l_pageShadowRight	class
l_topCorners	class
latestHeadlines_rdr	class
left_ctr	class
linksArea_fmt	class
links_fmt	class
loaded	class
logo_h1	id
logo_image	id
logo_tagline	id
lwe	id
m_search_top	id
m_tools	id
moduleSpacer_rdr	class
more	class
more_fmt	class
navColumnFiller_top_fmt	id
navColumn_area	id
navColumn_ctr	id
navbar_search	id
navbar_search_menu	id
news_feature_fmt	class
pagenav_form	id
pagenav_ibtn	id
pagenav_itxt	id
pagenav_menu	id
rb_nb_sp0	id
rb_nb_sp1	id
right_ctr	class
row	class
rowlist	class
rss_button_fmt	class
rss_text_fmt	class
searchButtonGo	id
searchButtonPlus	id
searchQuery_fmt	id
searchbox_009381416816438376069:lri1v9iomvy	id
smallfont	class
source	class
subheaderBar_fmt	class
tagline	class
teaser	class
thead	class
thirdColFiller_top_fmt	id
thirdCol_area	id
thirdCol_ctr	id
time	class
title	class
titleArea_fmt	class
top12List_fmt	class
top12Tabs_bottom_fmt	class
top12Tabs_header_fmt	class
top12Tabs_rdr	class
top12_footer_fmt	class
top12_header_fmt	class
top12_link_fmt	class
top12_number_fmt	class
top12_questionMark	class
top12_rdr	class
usercptools	id
usercptools_menu	id
vbmenu_control	class
vbmenu_option	class
vbmenu_popup	class
vbseo_top_menu	class
vbseo_vbmenu_control	class
vertFooterDivider	class